Stage ID,Real Duration,Estimated Duration,Error,Error Percentage,Size,Error/AppDuration
0,15228,11570,3658,0.2402153926976622,2.2809087680652738,0.0032148067424815005
64,7838,10769,2931,0.3739474355702985,2.2809087680652738,0.0025758880705886488
128,14807,5699,9108,0.6151144728844465,2.2809087680652738,0.008004499674828186
65,15024,31469,16445,1.0945820021299255,2.2809087680652738,0.014452568857328669
3,17431,19044,1613,0.09253628592737077,2.2809087680652738,0.001417573339426643
4,9345,8827,518,0.05543071161048689,2.2809087680652738,4.552405392579052E-4
5,12839,10250,2589,0.20165121894228522,2.2809087680652738,0.002275323853549646
6,20326,20912,586,0.028830069861261437,2.2809087680652738,5.150018455697537E-4
7,21850,54490,32640,1.4938215102974828,2.2809087680652738,0.028685427029687308
8,9065,37282,28217,3.1127413127413126,2.2809087680652738,0.02479830559119751
9,21275,-17179,38454,1.8074735605170387,2.2809087680652738,0.03379501871935036
270,18352,15962,2390,0.130231037489102,2.2809087680652738,0.002100434148313501
207,6662,8817,2155,0.3234764335034524,2.2809087680652738,0.0018939061044416711
208,7142,6131,1011,0.1415569868384206,2.2809087680652738,8.885100100188072E-4
209,12431,18476,6045,0.486284289276808,2.2809087680652738,0.005312604362575361
18,6086,10427,4341,0.7132763720013144,2.2809087680652738,0.0038150563338196263
82,6356,11640,5284,0.8313404657016992,2.2809087680652738,0.004643805037526585
19,7641,15153,7512,0.9831173930113859,2.2809087680652738,0.006601866661979506
83,8036,8792,756,0.09407665505226481,2.2809087680652738,6.644051113493751E-4
20,14453,31719,17266,1.1946308724832215,2.2809087680652738,0.015174098746770254
84,21543,13111,8432,0.3914032400315648,2.2809087680652738,0.007410401982669221
151,6187,5534,653,0.10554388233392598,2.2809087680652738,5.738843091417222E-4
152,7591,3862,3729,0.49123962587274406,2.2809087680652738,0.003277204577012989
153,12760,11780,980,0.0768025078369906,2.2809087680652738,8.612658850825234E-4
31,5180,37028,31848,6.148262548262548,2.2809087680652738,0.027989383579702248
32,11114,8452,2662,0.23951772539139823,2.2809087680652738,0.002339479373560895
33,19871,10519,9352,0.4706355996175331,2.2809087680652738,0.008218937303358938
103,5858,6012,154,0.02628883578012974,2.2809087680652738,1.3534178194153938E-4
104,8318,3745,4573,0.5497715797066602,2.2809087680652738,0.004018947849471815
105,22043,30346,8303,0.3766728666696911,2.2809087680652738,0.007297031269224685
46,4912,5491,579,0.11787459283387622,2.2809087680652738,5.088499463905929E-4
238,6136,6805,669,0.10902868318122555,2.2809087680652738,5.879457929798042E-4
47,7490,5703,1787,0.23858477970627504,2.2809087680652738,0.001570491976165785
239,7563,25422,17859,2.361364537881793,2.2809087680652738,0.01569525249151917
48,16221,39665,23444,1.445286973676099,2.2809087680652738,0.02060358919374967
240,15292,86530,71238,4.6585142558200365,2.2809087680652738,0.0626069991035804
178,6008,5412,596,0.09920106524633822,2.2809087680652738,5.23790272968555E-4
179,7351,10311,2960,0.4026663039042307,2.2809087680652738,0.0026013745100451724
180,16126,18777,2651,0.16439290586630287,2.2809087680652738,0.0023298121034222136
126,5937,10093,4156,0.7000168435236651,2.2809087680652738,0.003652470426941803
63,6566,11972,5406,0.8233323180018276,2.2809087680652738,0.00475102385179196
127,7878,1881,5997,0.7612338156892612,2.2809087680652738,0.005270419911061115
0,23485,26226,2741,0.11671279540131999,4.838452653028071,0.0029232001416275005
64,11994,12019,25,0.00208437552109388,4.838452653028071,2.6661803553698473E-5
128,39671,49584,9913,0.24988026518111467,4.838452653028071,0.010571938345112518
65,50576,57530,6954,0.13749604555520406,4.838452653028071,0.007416247276496767
3,21123,24325,3202,0.15158831605359088,4.838452653028071,0.0034148437991577004
4,13756,17082,3326,0.24178540273335272,4.838452653028071,0.0035470863447840447
5,18676,22706,4030,0.21578496466052688,4.838452653028071,0.0042978827328561935
6,26800,28504,1704,0.0635820895522388,4.838452653028071,0.0018172685302200878
7,50018,78298,28280,0.5653964572753809,4.838452653028071,0.03015983217994371
8,16437,43181,26744,1.62706089919085,4.838452653028071,0.02852173096960448
9,41408,97515,56107,1.354979714064915,4.838452653028071,0.059836552479494404
270,11000,15920,4920,0.44727272727272727,4.838452653028071,0.005247042939367859
207,12582,17444,4862,0.38642505166110314,4.838452653028071,0.005185187555123279
208,12858,13966,1108,0.0861720329755794,4.838452653028071,0.0011816511334999163
209,36525,43700,7175,0.19644079397672826,4.838452653028071,0.007651937619911462
18,12011,18652,6641,0.5529098326534011,4.838452653028071,0.007082441496004462
82,14421,20058,5637,0.39088828791345953,4.838452653028071,0.006011703465287932
19,13338,22860,9522,0.7139001349527665,4.838452653028071,0.010154947737532675
83,12718,18424,5706,0.44865544896996384,4.838452653028071,0.00608529004309614
20,40959,76140,35181,0.8589321028345419,4.838452653028071,0.03751955643290664
84,35551,54954,19403,0.5457793029731934,4.838452653028071,0.02069275897409646
151,12886,15081,2195,0.170339903771535,4.838452653028071,0.0023409063520147258
152,11397,12295,898,0.07879266473633412,4.838452653028071,9.576919836488491E-4
153,37470,48402,10932,0.29175340272217776,4.838452653028071,0.011658673457961267
31,12415,43355,30940,2.492146596858639,4.838452653028071,0.03299664807805723
32,14896,18304,3408,0.22878625134264233,4.838452653028071,0.0036345370604401756
33,37953,52660,14707,0.3875055990303797,4.838452653028071,0.015684605794569737
103,15699,16619,920,0.058602458755334735,4.838452653028071,9.811543707761038E-4
104,12292,13737,1445,0.11755613407094045,4.838452653028071,0.0015410522454037717
105,37880,56426,18546,0.4895987328405491,4.838452653028071,0.019778792348275676
46,16362,14365,1997,0.12205109399828871,4.838452653028071,0.002129744867869434
238,12682,16295,3613,0.28489197287494084,4.838452653028071,0.0038531638495805033
47,11025,15443,4418,0.4007256235827664,4.838452653028071,0.004711673924009594
239,10065,32846,22781,2.2633879781420765,4.838452653028071,0.024295301870272196
48,43196,64577,21381,0.49497638670247246,4.838452653028071,0.022802240871265082
240,37621,102650,65029,1.7285292788602111,4.838452653028071,0.06935161693173832
178,11678,14306,2628,0.22503853399554719,4.838452653028071,0.0028026887895647836
179,12783,18236,5453,0.4265821794570914,4.838452653028071,0.005815472591132711
180,41940,48742,6802,0.16218407248450167,4.838452653028071,0.00725414351089028
126,12054,18969,6915,0.5736684917869587,4.838452653028071,0.007374654862952998
63,12853,20085,7232,0.5626701937290904,4.838452653028071,0.007712726532013894
127,10447,11224,777,0.07437541878051115,4.838452653028071,8.286488544489485E-4
0,38130,40804,2674,0.07012850773669027,7.3821560107171535,0.0012614367831003323
64,19824,18412,1412,0.07122679580306698,7.3821560107171535,6.660990043895547E-4
128,56579,89506,32927,0.5819650400325209,7.3821560107171535,0.015533032519500615
65,63231,83451,20220,0.3197798548180481,7.3821560107171535,0.009538613221499147
3,29467,29577,110,0.0037329894458207487,7.3821560107171535,5.189156549776984E-5
4,22640,25292,2652,0.11713780918727915,7.3821560107171535,0.0012510584700007783
5,31103,35094,3991,0.12831559656624764,7.3821560107171535,0.001882720344559995
6,35911,36055,144,0.004009913397009273,7.3821560107171535,6.793077665162598E-5
7,68425,101977,33552,0.4903470953598831,7.3821560107171535,0.015827870959828853
8,34053,49047,14994,0.44031362875517577,7.3821560107171535,0.0070732921188505545
9,147258,182155,34897,0.23697863613521847,7.3821560107171535,0.01646236328341522
270,8019,16312,8293,1.0341688489836638,7.3821560107171535,0.003912152297027321
207,18534,26025,7491,0.4041761087730657,7.3821560107171535,0.003533815610398126
208,15938,21758,5820,0.3651650144309198,7.3821560107171535,0.0027455355563365496
209,60692,68788,8096,0.13339484610821856,7.3821560107171535,0.0038192192206358603
18,37317,26833,10484,0.28094434172093147,7.3821560107171535,0.004945737933441991
82,25944,28430,2486,0.09582176996608079,7.3821560107171535,0.0011727493802495984
19,38929,30524,8405,0.21590587993526678,7.3821560107171535,0.003964987345534141
83,14499,28004,13505,0.9314435478308849,7.3821560107171535,0.006370869018612561
20,102127,116719,14592,0.14288092277262623,7.3821560107171535,0.006883652034031432
84,75361,93956,18595,0.2467456642029697,7.3821560107171535,0.00877203327664573
151,22623,24575,1952,0.0862838703973832,7.3821560107171535,9.208394168331521E-4
152,14444,20681,6237,0.4318055940182775,7.3821560107171535,0.00294225176372355
153,58743,82415,23672,0.4029756736972916,7.3821560107171535,0.01116706489512007
31,41774,49647,7873,0.18846651026954564,7.3821560107171535,0.003714020865126745
32,35969,28102,7867,0.21871611665600935,7.3821560107171535,0.003711190416099594
33,74912,91240,16328,0.21796240922682614,7.3821560107171535,0.007702595285887145
103,28424,26818,1606,0.0565015479876161,7.3821560107171535,7.576168562674397E-4
104,18712,23674,4962,0.2651774262505344,7.3821560107171535,0.002340781345453945
105,61769,82365,20596,0.33343586588741925,7.3821560107171535,0.009715988027200615
46,23553,23191,362,0.015369591984036004,7.3821560107171535,1.707704246381153E-4
238,23364,25733,2369,0.10139530902242766,7.3821560107171535,0.0011175556242201522
47,19927,25130,5203,0.26110302604506447,7.3821560107171535,0.0024544710480445134
239,140267,40230,100037,0.7131898450811667,7.3821560107171535,0.04719160488818547
48,85189,89355,4166,0.04890302738616488,7.3821560107171535,0.0019652751078519013
240,367008,118683,248325,0.676620128171593,7.3821560107171535,0.11714520911121541
178,18735,23151,4416,0.2357085668534828,7.3821560107171535,0.0020832104839831967
179,14732,26118,11386,0.7728753733369536,7.3821560107171535,0.005371248770523704
180,62419,77165,14746,0.23624216985212837,7.3821560107171535,0.00695630022572831
126,22816,27797,4981,0.2183117110799439,7.3821560107171535,0.0023497444340399233
63,45350,28155,17195,0.37916207276736497,7.3821560107171535,0.008111595170310477
127,16420,20517,4097,0.2495127892813642,7.3821560107171535,0.001932724944039664
0,57150,55423,1727,0.030218722659667543,9.9330182550475,5.204247895775218E-4
64,39975,28798,11177,0.27959974984365227,9.9330182550475,0.0033681458443010773
128,158228,125808,32420,0.20489420330156483,9.9330182550475,0.009769641967633616
65,143970,109444,34526,0.23981385010766132,9.9330182550475,0.010404276945543437
3,33720,34844,1124,0.03333333333333333,9.9330182550475,3.387130651332568E-4
4,34137,33526,611,0.01789846793801447,9.9330182550475,1.841224935911209E-4
5,47451,47517,66,0.0013909085161535057,9.9330182550475,1.988884546156134E-5
6,40744,43627,2883,0.07075888474376596,9.9330182550475,8.687809312982022E-4
7,169456,125723,43733,0.2580787933150788,9.9330182550475,0.013178770887431244
8,135537,54931,80606,0.5947158340526941,9.9330182550475,0.024290307231433536
9,255785,242304,13481,0.05270441972750552,9.9330182550475,0.004062447358595582
270,29227,17140,12087,0.41355595853149485,9.9330182550475,0.0036423708347559382
207,32458,34629,2171,0.06688643785815515,9.9330182550475,6.542224772280253E-4
208,32336,29572,2764,0.08547748639287482,9.9330182550475,8.329207402387204E-4
209,124756,93946,30810,0.24696206996056302,9.9330182550475,0.009284474676828863
18,39656,35036,4620,0.11650191648174299,9.9330182550475,0.0013922191823092938
82,28885,36827,7942,0.27495239743811667,9.9330182550475,0.0023932910705412144
19,66308,38210,28098,0.4237497737829523,9.9330182550475,0.008467223936044705
83,42555,37610,4945,0.11620256139114088,9.9330182550475,0.0014901566789003156
20,215615,153805,61810,0.2866683672286251,9.9330182550475,0.018626205120895554
84,173322,130450,42872,0.2473546347261167,9.9330182550475,0.012919311858000876
151,34564,34097,467,0.013511167688924892,9.9330182550475,1.4072864894771434E-4
152,29131,29092,39,0.0013387799938210155,9.9330182550475,1.175249959092261E-5
153,152298,114108,38190,0.25075838159398023,9.9330182550475,0.011508409214803448
31,147242,55957,91285,0.6199657706360957,9.9330182550475,0.027508382696342832
32,33965,37928,3963,0.11667893419696747,9.9330182550475,0.0011942347661237514
33,135725,126590,9135,0.06730521274636213,9.9330182550475,0.002752797019566104
103,39195,36695,2500,0.06378364587319811,9.9330182550475,7.533653583924751E-4
104,34034,33639,395,0.011606041017805723,9.9330182550475,1.1903172662601105E-4
105,133406,108377,25029,0.18761524968891954,9.9330182550475,0.007542392622082103
46,30643,32042,1399,0.04565479881212675,9.9330182550475,4.21583254556429E-4
238,33050,35199,2149,0.06502269288956126,9.9330182550475,6.475928620741715E-4
47,39443,34845,4598,0.11657328296529168,9.9330182550475,0.00138558956715544
239,26834,47634,20800,0.7751360214653052,9.9330182550475,0.006267999781825392
48,174841,114202,60639,0.3468236855199867,9.9330182550475,0.018273328787024517
240,97572,134761,37189,0.38114418070758005,9.9330182550475,0.011206761725303101
178,31089,32022,933,0.03001061468686674,9.9330182550475,2.811559517520717E-4
179,51067,34022,17045,0.33377719466583117,9.9330182550475,0.005136445013519894
180,141691,104286,37405,0.263989949961536,9.9330182550475,0.011271852492268211
126,32776,36650,3874,0.11819624115206248,9.9330182550475,0.0011674149593649793
63,30946,36247,5301,0.171298390745169,9.9330182550475,0.001597435905935404
127,25510,29836,4326,0.16958055664445315,9.9330182550475,0.0013036234161623388
0,70322,69962,360,0.005119308324564148,12.470088510774076,8.082778428142079E-5
64,35838,41904,6066,0.16926167754897037,12.470088510774076,0.0013619481651419402
128,201406,158208,43198,0.2144821902028738,12.470088510774076,0.009698885070524486
65,178521,135297,43224,0.24212277547179323,12.470088510774076,0.00970472263272259
3,44338,40083,4255,0.09596734178357165,12.470088510774076,9.55339505881793E-4
4,42332,41715,617,0.014575262212983086,12.470088510774076,1.3852984139343507E-4
5,56592,59873,3281,0.05797639242295731,12.470088510774076,7.36655445075949E-4
6,56528,51157,5371,0.09501485989244268,12.470088510774076,0.0012059056371541974
7,209557,149340,60217,0.28735379872779243,12.470088510774076,0.013520018572428655
8,91119,60782,30337,0.33293824559093055,12.470088510774076,0.006811312477070729
9,391856,282273,109583,0.27965119839941205,12.470088510774076,0.024603753013641486
270,27903,18395,9508,0.3407518904777264,12.470088510774076,0.0021347515915215247
207,77807,43188,34619,0.44493426041358747,12.470088510774076,0.007772714066773629
208,35506,37344,1838,0.05176589872134287,12.470088510774076,4.1267074308125394E-4
209,196485,118969,77516,0.39451357609995674,12.470088510774076,0.01740401812877393
18,44049,43196,853,0.01936479829281028,12.470088510774076,1.9151694442236648E-4
82,80060,45177,34883,0.4357107169622783,12.470088510774076,0.007831987775246671
19,41218,45855,4637,0.11249939346887282,12.470088510774076,0.0010411067658693007
83,64206,47165,17041,0.2654113322742423,12.470088510774076,0.0038260729776102547
20,308366,187109,121257,0.39322428542705745,12.470088510774076,0.02722481844058956
84,207282,164145,43137,0.20810779517758415,12.470088510774076,0.009685189251521247
151,70565,43567,26998,0.38259760504499396,12.470088510774076,0.006061634777860552
152,42296,37457,4839,0.11440798184225459,12.470088510774076,0.001086460133716098
153,190428,143232,47196,0.24784170395109964,12.470088510774076,0.010596522519294266
31,110985,62232,48753,0.4392755777807812,12.470088510774076,0.010946102686311411
32,54072,47701,6371,0.11782438230507472,12.470088510774076,0.0014304272601581441
33,242925,158433,84492,0.34781105279407226,12.470088510774076,0.01897028097084946
103,44406,46170,1764,0.039724361572760436,12.470088510774076,3.960561429789619E-4
104,39637,43550,3913,0.0987208920957691,12.470088510774076,8.785531108144432E-4
105,217570,134249,83321,0.3829618053959645,12.470088510774076,0.01870736615031184
46,46557,40845,5712,0.12268831754623365,12.470088510774076,0.0012824675105985433
238,73630,44613,29017,0.39409208203178053,12.470088510774076,0.00651494393470552
47,42379,44507,2128,0.05021354916350079,12.470088510774076,4.7778201375239847E-4
239,57141,54999,2142,0.037486218302094816,12.470088510774076,4.809253164744537E-4
48,178859,138915,39944,0.22332675459440118,12.470088510774076,0.008968291709269645
240,191471,150753,40718,0.21265883606394703,12.470088510774076,0.009142071445474699
178,49029,40844,8185,0.16694201391013483,12.470088510774076,0.0018377094842873033
179,60173,41883,18290,0.3039569242018846,12.470088510774076,0.004106500484742184
180,163540,129888,33652,0.2057722881252293,12.470088510774076,0.007555601657328812
126,84456,45455,39001,0.4617907549493227,12.470088510774076,0.008756567818776923
63,55396,44295,11101,0.20039353021878836,12.470088510774076,0.002492414536966812
127,34570,39105,4535,0.13118310673994793,12.470088510774076,0.001018205560322898
0,88494,84525,3969,0.044850498338870434,15.0111934710294,0.0011887244588218839
64,62197,56632,5565,0.08947376883129411,15.0111934710294,0.001666730061311107
128,136256,186953,50697,0.3720716885861907,15.0111934710294,0.015183865933205606
65,138669,161191,22522,0.1624155362770338,15.0111934710294,0.006745389836630504
3,50234,45329,4905,0.09764303061671378,15.0111934710294,0.0014690585715599245
4,58915,49917,8998,0.15272850717134856,15.0111934710294,0.002694921310274455
5,84642,72248,12394,0.1464284870395312,15.0111934710294,0.0037120309757214484
6,60555,58700,1855,0.030633308562463876,15.0111934710294,5.555766871037024E-4
7,272152,172995,99157,0.3643441900114642,15.0111934710294,0.029697745317057583
8,49985,66643,16658,0.333259977993398,15.0111934710294,0.004989108600416967
9,256193,307162,50969,0.19894766835940092,15.0111934710294,0.015265330547163669
270,12824,20084,7260,0.566126013724267,15.0111934710294,0.0021743863872630076
207,43050,51759,8709,0.20229965156794424,15.0111934710294,0.002608365157944013
208,39455,45129,5674,0.14380940311747561,15.0111934710294,0.001699375807345772
209,102074,144031,41957,0.41104492818935284,15.0111934710294,0.012566216205288432
18,47058,51368,4310,0.09158910280929916,15.0111934710294,0.0012908547285266614
82,42221,53542,11321,0.26813670922053007,15.0111934710294,0.0033906650537471775
19,43699,53511,9812,0.22453603057278199,15.0111934710294,0.0029387161476342465
83,39215,56734,17519,0.44674231799056485,15.0111934710294,0.005246980043865101
20,181653,216884,35231,0.19394670057747462,15.0111934710294,0.010551764023369561
84,136296,195294,58998,0.4328667018841345,15.0111934710294,0.017670034170212522
151,43551,53052,9501,0.21815802162981332,15.0111934710294,0.0028455709456454317
152,44162,45835,1673,0.03788324804130248,15.0111934710294,5.010672762935278E-4
153,151318,170004,18686,0.12348828295377946,15.0111934710294,0.0055964991780160555
31,43255,68518,25263,0.5840480869263669,15.0111934710294,0.0075663255236123085
32,49079,57489,8410,0.1713563846044133,15.0111934710294,0.002518813983041583
33,142089,187013,44924,0.3161680355270288,15.0111934710294,0.013454839402397157
103,51492,55312,3820,0.0741862813640954,15.0111934710294,0.0011440986224992686
104,41501,53477,11976,0.2885713597262717,15.0111934710294,0.003586839032212366
105,152646,160161,7515,0.0492315553633898,15.0111934710294,0.002250759462848692
46,41272,49662,8390,0.20328552044969955,15.0111934710294,0.002512823937897608
238,45584,54042,8458,0.18554756054756055,15.0111934710294,0.002533190091387124
47,71287,54184,17103,0.23991751651773816,15.0111934710294,0.005122387104870416
239,42427,62375,19948,0.4701722959436208,15.0111934710294,0.005974471026600892
48,127876,163668,35792,0.2798961493947261,15.0111934710294,0.010719784789658068
240,114653,166769,52116,0.4545541765152242,15.0111934710294,0.015608859636170648
178,41560,49680,8120,0.19538017324350337,15.0111934710294,0.0024319583284539426
179,40303,49757,9454,0.2345731087015855,15.0111934710294,0.0028314943395570903
180,108894,154157,45263,0.4156611016217606,15.0111934710294,0.013556370667587535
126,42471,54275,11804,0.27793082338536884,15.0111934710294,0.0035353246439741794
63,41839,52356,10517,0.25136834054351204,15.0111934710294,0.0031498652389593735
127,36262,48388,12126,0.33439964701340247,15.0111934710294,0.0036317643707921804
0,92872,99127,6255,0.06735076233956414,17.559313969686627,0.0015982522708980107
64,54158,71835,17677,0.32639683887883597,17.559313969686627,0.004516755458459494
128,211539,212054,515,0.002434539257536435,17.559313969686627,1.315907145503558E-4
65,204246,187157,17089,0.08366871321837392,17.559313969686627,0.004366512079516564
3,49930,50591,661,0.013238533947526537,17.559313969686627,1.6889604333550522E-4
4,55777,58141,2364,0.04238306111838213,17.559313969686627,6.040397071787206E-4
5,81059,84658,3599,0.04439975820081669,17.559313969686627,9.196019061489914E-4
6,62902,66264,3362,0.05344822104225621,17.559313969686627,8.590446258607693E-4
7,170078,196716,26638,0.15662225567092747,17.559313969686627,0.006806433891635685
8,59351,72520,13169,0.22188337180502435,17.559313969686627,0.00336488955323036
9,301274,321625,20351,0.06754980516075068,17.559313969686627,0.0052000051103190115
270,19415,22211,2796,0.14401236157610095,17.559313969686627,7.144225978306696E-4
207,50984,60355,9371,0.18380276165071394,17.559313969686627,0.002394439972915309
208,58337,52934,5403,0.09261703550062568,17.559313969686627,0.0013805526810011116
209,143770,169162,25392,0.1766154274187939,17.559313969686627,0.006488061017209
18,55474,59563,4089,0.07371020658326423,17.559313969686627,0.0010448047219347668
82,55649,61929,6280,0.11285018598716957,17.559313969686627,0.0016046401696625911
19,55720,61189,5469,0.09815147164393395,17.559313969686627,0.0013974167337396036
83,76836,66330,10506,0.1367327815086678,17.559313969686627,0.0026844505768272584
20,194441,243143,48702,0.25047186550161743,17.559313969686627,0.012444137825303745
84,187522,223917,36395,0.19408389415641897,17.559313969686627,0.009299503021476115
151,50870,62563,11693,0.2298604285433458,17.559313969686627,0.0029877480101695346
152,54910,54236,674,0.012274631214714988,17.559313969686627,1.7221775069308702E-4
153,137018,194441,57423,0.4190909223605658,17.559313969686627,0.014672492430339964
31,56904,74821,17917,0.3148636299732884,17.559313969686627,0.004578079286599466
32,51678,67305,15627,0.30239173342621617,17.559313969686627,0.003992947759763903
33,154244,212340,58096,0.37664998314359066,17.559313969686627,0.014844454665082468
103,69365,64129,5236,0.07548475455921574,17.559313969686627,0.0013378815172537147
104,68637,63431,5206,0.07584830339321358,17.559313969686627,0.0013302160387362182
105,139736,186145,46409,0.33211913894773,17.559313969686627,0.011858239750616431
46,57093,58503,1410,0.02469654773790132,17.559313969686627,3.6027749032233335E-4
238,57218,63497,6279,0.109738194274529,17.559313969686627,0.001604384653712008
47,52945,63888,10943,0.2066861837756162,17.559313969686627,0.0027961110472321236
239,49062,69771,20709,0.4220985691573927,17.559313969686627,0.005291479820627803
48,157031,188488,31457,0.20032350300259186,17.559313969686627,0.008037765257496199
240,128520,182830,54310,0.42258014316837844,17.559313969686627,0.013877071276174414
178,62253,58541,3712,0.05962764846674056,17.559313969686627,9.484752085648947E-4
179,56368,57653,1285,0.0227966221969912,17.559313969686627,3.2833799649943147E-4
180,172768,177114,4346,0.025155121318762734,17.559313969686627,0.0011104723212346532
126,61061,63118,2057,0.033687623851558275,17.559313969686627,5.255963103496736E-4
63,55128,60440,5312,0.0963575678421129,17.559313969686627,0.0013573007294980389
127,52869,57697,4828,0.09132005523085363,17.559313969686627,0.0012336310094157629
0,110560,113812,3252,0.029413892908827784,20.121650571003556,7.082267109489846E-4
64,85456,86368,912,0.010672158771765586,20.121650571003556,1.9861708498938312E-4
128,235045,233535,1510,0.006424301729456062,20.121650571003556,3.2885065606794796E-4
65,168127,213267,45140,0.26848751241620916,20.121650571003556,0.009830674579408722
3,59952,55882,4070,0.06788764344809181,20.121650571003556,8.863722981434093E-4
4,62747,66412,3665,0.058409166972126156,20.121650571003556,7.981706321119399E-4
5,91265,97137,5872,0.06434010847531912,20.121650571003556,0.0012788152665105896
6,77480,73870,3610,0.046592669075890554,20.121650571003556,7.861926280829749E-4
7,156488,220568,64080,0.4094882674709882,20.121650571003556,0.013955463603201395
8,77185,78430,1245,0.016130077087517004,20.121650571003556,2.7113845483748027E-4
9,307879,330360,22481,0.07301894575466336,20.121650571003556,0.004895954701366581
270,25740,24788,952,0.03698523698523699,20.121650571003556,2.0732836064681222E-4
207,66806,68998,2192,0.03281142412358171,20.121650571003556,4.7737790602711387E-4
208,68433,60784,7649,0.11177355953998802,20.121650571003556,0.0016658136875918768
209,152543,194433,41890,0.2746110932655055,20.121650571003556,0.00912288343224261
18,67129,67803,674,0.01004037003381549,20.121650571003556,1.4678499482768007E-4
82,68055,70363,2308,0.03391374623466314,20.121650571003556,5.026406054336582E-4
19,69548,68910,638,0.009173520446310462,20.121650571003556,1.389448467359939E-4
83,67230,75980,8750,0.13015023055183697,20.121650571003556,0.0019055915500626123
20,221864,265914,44050,0.19854505462806044,20.121650571003556,0.009593292317743779
84,280649,250061,30588,0.10899023335198059,20.121650571003556,0.006661512495236021
151,61067,72127,11060,0.18111254851228978,20.121650571003556,0.002408667719279142
152,60277,62685,2408,0.03994890256648473,20.121650571003556,5.244187945772309E-4
153,222503,216581,5922,0.026615371478137372,20.121650571003556,0.001289704361082376
31,64340,81159,16819,0.26140814423375813,20.121650571003556,0.0036628736320574945
32,75877,77175,1298,0.017106633103575523,20.121650571003556,2.826808950835738E-4
33,217604,234445,16841,0.07739287880737486,20.121650571003556,0.0036676648336690806
103,64607,72641,8034,0.12435185041868528,20.121650571003556,0.0017496597157946317
104,62375,73441,11066,0.1774108216432866,20.121650571003556,0.0024099744106277562
105,211175,212274,1099,0.005204214514028649,20.121650571003556,2.393422986878641E-4
46,57673,67393,9720,0.1685364035163768,20.121650571003556,0.0021168399847552675
238,61239,73005,11766,0.1921324646058884,20.121650571003556,0.0025624217346327653
47,69521,73647,4126,0.0593489736914026,20.121650571003556,8.985680840638101E-4
239,62793,77209,14416,0.22957973022470657,20.121650571003556,0.0031395437469374423
48,195288,213448,18160,0.09299086477407727,20.121650571003556,0.003954919148472805
240,150921,198981,48060,0.3184447492396684,20.121650571003556,0.010466597702401045
178,63802,67451,3649,0.05719256449641077,20.121650571003556,7.946861218489683E-4
179,58953,65593,6640,0.11263209675504215,20.121650571003556,0.001446071759133228
180,186587,198806,12219,0.06548687743519109,20.121650571003556,0.0026610769314531495
126,65745,72011,6266,0.0953076279564986,20.121650571003556,0.0013646213317362662
63,61885,68568,6683,0.10799062777732892,20.121650571003556,0.0014554363804649643
127,90323,67058,23265,0.25757558982761863,20.121650571003556,0.005066695704252192
0,131638,129349,2289,0.017388595998116044,22.83291306067258,3.8075980294307866E-4
64,114942,99589,15353,0.13357171442988638,22.83291306067258,0.002553868612750147
128,287401,252159,35242,0.12262309456125761,22.83291306067258,0.005862270412983826
65,300385,240895,59490,0.19804584117049787,22.83291306067258,0.009895762637432831
3,59089,61480,2391,0.040464384233952176,22.83291306067258,3.977268190637401E-4
4,79416,75163,4253,0.05355344011282361,22.83291306067258,7.074580349134616E-4
5,118920,110341,8579,0.07214093508240835,22.83291306067258,0.0014270591303838672
6,83186,81918,1268,0.015242949534777487,22.83291306067258,2.1092329844116372E-4
7,244592,245807,1215,0.004967456008373127,22.83291306067258,2.021071037902318E-4
8,89027,84684,4343,0.048782953486021095,22.83291306067258,7.224289314905158E-4
9,366969,338604,28365,0.07729535737351112,22.83291306067258,0.004718327571201584
270,22990,27992,5002,0.21757285776424531,22.83291306067258,8.320491630936127E-4
207,81744,78144,3600,0.04403992953611274,22.83291306067258,5.988358630821683E-4
208,80686,69089,11597,0.14373001512034306,22.83291306067258,0.0019290831956010849
209,214904,221174,6270,0.029175818039682836,22.83291306067258,0.0010429724615347764
18,82372,76523,5849,0.07100713834798232,22.83291306067258,9.729419342132228E-4
82,90843,79287,11556,0.127208480565371,22.83291306067258,0.0019222631204937602
19,71547,77079,5532,0.07731980376535703,22.83291306067258,9.202111096029319E-4
83,131925,86191,45734,0.3466666666666667,22.83291306067258,0.007607544267277745
20,290247,286040,4207,0.01449455119260492,22.83291306067258,6.998062433296339E-4
84,293044,274843,18201,0.06211012680689589,22.83291306067258,0.003027614317766262
151,85804,82247,3557,0.041454943825462685,22.83291306067258,5.916831013842423E-4
152,63199,71624,8425,0.1333090713460656,22.83291306067258,0.0014014422629075743
153,261803,237350,24453,0.09340229103562603,22.83291306067258,0.004067592599985628
31,85499,87866,2367,0.027684534322038854,22.83291306067258,3.9373457997652565E-4
32,104473,87618,16855,0.16133355029529162,22.83291306067258,0.0028037162422916515
33,280678,254162,26516,0.09447124462907673,22.83291306067258,0.00441075881819077
103,84048,81262,2786,0.03314772510946126,22.83291306067258,4.63432420707478E-4
104,119204,84033,35171,0.295048823864971,22.83291306067258,0.005850460039017484
105,254412,239922,14490,0.05695486061978208,22.83291306067258,0.0024103143489057274
46,89064,76801,12263,0.13768750561394053,22.83291306067258,0.002039867830271286
238,82836,83066,230,0.002776570573180743,22.83291306067258,3.825895791913853E-5
47,78349,83972,5623,0.07176862499840457,22.83291306067258,9.353483494752867E-4
239,85286,85079,207,0.002427127547311399,22.83291306067258,3.443306212722468E-5
48,297701,239857,57844,0.19430233690850887,22.83291306067258,0.009621961573368039
240,241155,216070,25085,0.10402023594783438,22.83291306067258,0.0041727215626156085
178,88819,76879,11940,0.13443069613483602,22.83291306067258,0.0019861389458891913
179,87552,73994,13558,0.1548565423976608,22.83291306067258,0.002255282397685566
180,231533,220239,11294,0.048779223695974226,22.83291306067258,0.0018786811771250023
126,89525,81421,8104,0.09052220050265289,22.83291306067258,0.001348046065116081
63,92209,77169,15040,0.16310772267349175,22.83291306067258,0.0025018031613210584
127,79123,76963,2160,0.02729926822794889,22.83291306067258,3.5930151784930095E-4
0,147828,145629,2199,0.014875395730172904,25.673576389439404,3.71766569140636E-4
64,97253,109540,12287,0.12634057561206338,25.673576389439404,0.00207726049796771
128,234146,267143,32997,0.14092489301546898,25.673576389439404,0.005578527276913854
65,232580,269842,37262,0.16021154011522917,25.673576389439404,0.006299575215697306
3,67763,67345,418,0.0061685580626595635,25.673576389439404,7.066776985028914E-5
4,83246,84332,1086,0.013045671864113591,25.673576389439404,1.8360095229046414E-4
5,128760,124175,4585,0.03560888474681578,25.673576389439404,7.751476668985066E-4
6,92273,90350,1923,0.020840332491628102,25.673576389439404,3.25105553641402E-4
7,282165,272251,9914,0.035135470380805556,25.673576389439404,0.0016760772016645134
8,93007,91235,1772,0.0190523293945617,25.673576389439404,2.9957724443711094E-4
9,364844,352255,12589,0.03450515836905636,25.673576389439404,0.002128317116376292
270,31578,31878,300,0.009500285008550257,25.673576389439404,5.0718495107863024E-5
207,93268,87726,5542,0.05942016554445254,25.673576389439404,9.369396662925896E-4
208,76367,77791,1424,0.018646797700577474,25.673576389439404,2.4074379011198983E-4
209,231653,249190,17537,0.07570374655195486,25.673576389439404,0.0029648341623553127
18,86021,85658,363,0.004219899791911277,25.673576389439404,6.136937908051425E-5
82,101067,88637,12430,0.12298772101675126,25.673576389439404,0.0021014363139691245
19,75365,85638,10273,0.13630995820341008,25.673576389439404,0.0017367703341435894
83,82940,96889,13949,0.16818181818181818,25.673576389439404,0.002358240960865271
20,310056,302750,7306,0.02356348530588023,25.673576389439404,0.001235164417526824
84,300377,297631,2746,0.009141845081347773,25.673576389439404,4.642432918873062E-4
151,93455,92850,605,0.0064737039216735326,25.673576389439404,1.0228229846752376E-4
152,92327,80990,11337,0.12279181604514389,25.673576389439404,0.0019166519301261438
153,252523,256181,3658,0.014485809213418183,25.673576389439404,6.184275170152098E-4
31,88994,94893,5899,0.06628536755286873,25.673576389439404,9.972946754709467E-4
32,92229,98561,6332,0.06865519522059223,25.673576389439404,0.0010704983700766289
33,299968,270769,29199,0.09734038297418392,25.673576389439404,0.004936431128848308
103,93689,89868,3821,0.0407838700381048,25.673576389439404,6.459845660238153E-4
104,103063,95130,7933,0.07697233730824836,25.673576389439404,0.001341166072302258
105,246514,268889,22375,0.09076563602878539,25.673576389439404,0.0037827544267947837
46,93263,86657,6606,0.07083194836108639,25.673576389439404,0.0011168212622751437
238,86543,93606,7063,0.08161260876096275,25.673576389439404,0.0011940824364894552
47,109346,94790,14556,0.13311872405026248,25.673576389439404,0.002460861382633514
239,73363,93325,19962,0.27209901448959284,25.673576389439404,0.0033748086644772054
48,261939,267528,5589,0.02133702885022849,25.673576389439404,9.448855638594881E-4
240,181117,233975,52858,0.29184449830772374,25.673576389439404,0.008936260714704746
178,89535,86757,2778,0.031026972692243256,25.673576389439404,4.696532646988116E-4
179,68267,82796,14529,0.21282610924751344,25.673576389439404,0.0024562967180738063
180,243990,241017,2973,0.012184925611705397,25.673576389439404,5.026202865189226E-4
126,88763,91280,2517,0.02835640976533015,25.673576389439404,4.2552817395497076E-4
63,89238,86181,3057,0.034256706784105424,25.673576389439404,5.168214651491242E-4
127,77974,87341,9367,0.1201297868520276,25.673576389439404,0.0015836004789178432
0,162865,161875,990,0.00607865410002149,28.50847167056054,1.5559126645790195E-4
64,118657,113885,4772,0.04021675923038674,28.50847167056054,7.499813369061698E-4
128,266189,277476,11287,0.04240220294602707,28.50847167056054,0.0017738976005154943
65,268010,298730,30720,0.11462258870937651,28.50847167056054,0.004828044147057321
3,69375,73199,3824,0.05512072072072072,28.50847167056054,6.009909120555728E-4
4,96989,93482,3507,0.03615873965088825,28.50847167056054,5.511702742099617E-4
5,137958,137982,24,1.739659896490236E-4,28.50847167056054,3.7719094898885323E-6
6,95506,98765,3259,0.03412351056478127,28.50847167056054,5.121938761477803E-4
7,255914,298641,42727,0.16695843134803098,28.50847167056054,0.006715099032269471
8,97025,97774,749,0.007719659881473847,28.50847167056054,1.177150086636046E-4
9,334743,377441,42698,0.12755457171621215,28.50847167056054,0.006710541308302523
270,38017,36293,1724,0.045348133729647265,28.50847167056054,2.709488316903262E-4
207,95242,97289,2047,0.021492618802629093,28.50847167056054,3.217124469084094E-4
208,70215,86476,16261,0.23158869187495548,28.50847167056054,0.0025556258422948924
209,274765,277150,2385,0.008680144851054538,28.50847167056054,3.748335055576729E-4
18,99891,94776,5115,0.05120581433762801,28.50847167056054,8.038882100324935E-4
82,96499,97968,1469,0.015222955678297184,28.50847167056054,2.3087229336026058E-4
19,117004,94180,22824,0.19507025400840997,28.50847167056054,0.0035870859248839943
83,99634,107565,7931,0.07960134090772227,28.50847167056054,0.0012464589235127478
20,274254,314961,40707,0.14842809949900457,28.50847167056054,0.006397629983537187
84,278235,317131,38896,0.1397954966125757,28.50847167056054,0.006113007979946014
151,97638,103432,5794,0.05934164976750855,28.50847167056054,9.106018160172565E-4
152,95703,90337,5366,0.05606929772316437,28.50847167056054,8.43336096780911E-4
153,241965,271984,30019,0.12406339759882627,28.50847167056054,0.0047178729573734935
31,101211,101905,694,0.006856962187904477,28.50847167056054,1.090710494159434E-4
32,121015,109481,11534,0.09531049869850845,28.50847167056054,0.0018127168356822639
33,280299,283210,2911,0.010385338513515923,28.50847167056054,4.5750118854439654E-4
103,102046,98023,4023,0.0394233972914176,28.50847167056054,6.322663282425652E-4
104,107815,106204,1611,0.01494226220841256,28.50847167056054,2.5318942450876773E-4
105,278978,297798,18820,0.06746051659987526,28.50847167056054,0.0029578056916542573
46,95711,96493,782,0.008170429731169876,28.50847167056054,1.2290138421220133E-4
238,111683,104126,7557,0.06766472963656062,28.50847167056054,0.0011876800006286516
47,109086,105586,3500,0.03208477714830501,28.50847167056054,5.500701339420776E-4
239,105677,101554,4123,0.039015112086830624,28.50847167056054,6.479826177837675E-4
48,294139,295142,1003,0.0034099524374530408,28.50847167056054,1.5763438409825825E-4
240,233070,251843,18773,0.08054661689621144,28.50847167056054,0.002950419035569892
178,101495,96615,4880,0.04808118626533327,28.50847167056054,7.669549296106682E-4
179,95443,91581,3862,0.040463941829154575,28.50847167056054,6.069631020812296E-4
180,252034,260041,8007,0.03176952315957371,28.50847167056054,0.0012584033035640616
126,92166,101119,8953,0.09713994314606254,28.50847167056054,0.0014070794026238345
63,98416,95174,3242,0.032941798081612746,28.50847167056054,5.095221069257758E-4
127,136796,97697,39099,0.2858197608117196,28.50847167056054,0.006144912047714655
0,181319,178100,3219,0.017753241524605806,31.339639127254486,4.2835693643483806E-4
64,118233,111031,7202,0.06091361971699948,31.339639127254486,9.583804461645554E-4
128,305321,283190,22131,0.0724843689100979,31.339639127254486,0.0029450038397761417
65,360521,327580,32941,0.09137054429561663,31.339639127254486,0.004383506009040075
3,74918,79045,4127,0.055086895005205694,31.339639127254486,5.491857957957678E-4
4,96783,102621,5838,0.06032051083351415,31.339639127254486,7.768710142611321E-4
5,146180,151770,5590,0.0382405253796689,31.339639127254486,7.438692993696007E-4
6,101269,107169,5900,0.058260672071413756,31.339639127254486,7.851214429840151E-4
7,330992,324996,5996,0.018115241455986853,31.339639127254486,7.978963003613821E-4
8,93494,104304,10810,0.11562239288082658,31.339639127254486,0.0014385021692639327
9,453577,420641,32936,0.07261391119920102,31.339639127254486,0.004382840651885003
270,45740,41239,4501,0.09840402273721031,31.339639127254486,5.989545109950935E-4
207,103484,106839,3355,0.03242047079741796,31.339639127254486,4.4645465105277467E-4
208,99874,95148,4726,0.04731962272463304,31.339639127254486,6.288955829732975E-4
209,389548,305073,84475,0.21685389220327148,31.339639127254486,0.011241209134927911
18,98080,103881,5801,0.05914559543230016,31.339639127254486,7.719473713136053E-4
82,93646,107287,13641,0.1456655916963885,31.339639127254486,0.0018152273904652456
19,104146,102711,1435,0.013778733700766233,31.339639127254486,1.9095750350543416E-4
83,115645,118227,2582,0.02232694885209045,31.339639127254486,3.435904348787673E-4
20,346593,322703,23890,0.06892810876157338,31.339639127254486,0.0031790764869301896
84,375409,333373,42036,0.11197387382827796,31.339639127254486,0.005593790674114586
151,120276,114000,6276,0.05217998603212611,31.339639127254486,8.351563010453693E-4
152,96902,99671,2769,0.028575261604507646,31.339639127254486,3.6847479247843014E-4
153,329424,284785,44639,0.13550621691194328,31.339639127254486,0.005940175609044652
31,95653,108908,13255,0.13857380322624485,31.339639127254486,0.001763861818093749
32,119896,120386,490,0.004086875291919664,31.339639127254486,6.520500119697752E-5
33,307713,291514,16199,0.05264320974414471,31.339639127254486,0.0021556241109996713
103,98283,105733,7450,0.07580151196035936,31.339639127254486,9.913821610560867E-4
104,91849,117264,25415,0.27670415573386753,31.339639127254486,0.0033820104192269058
105,329713,326668,3045,0.009235304643735613,31.339639127254486,4.0520250743836033E-4
46,102860,106317,3457,0.03360878864475987,31.339639127254486,4.6002793701622715E-4
238,137514,114631,22883,0.16640487513998575,31.339639127254486,0.00304507355589885
47,109011,116368,7357,0.06748860206768124,31.339639127254486,9.790065179717624E-4
239,140975,109772,31203,0.2213371165100195,31.339639127254486,0.004152227861937326
48,326516,322720,3796,0.011625770253218832,31.339639127254486,5.051391521300545E-4
240,408080,269688,138392,0.3391295824348167,31.339639127254486,0.01841602148092268
178,99419,106460,7041,0.07082147275671652,31.339639127254486,9.369559457712627E-4
179,97901,100353,2452,0.025045709441170162,31.339639127254486,3.262911488469161E-4
180,293385,277334,16051,0.05470968181740716,31.339639127254486,0.0021359295392095637
126,126852,110945,15907,0.1253981017248447,31.339639127254486,0.002116767253143513
63,97220,104156,6936,0.07134334499074264,31.339639127254486,9.229834455147675E-4
127,95356,108040,12684,0.13301732455220436,31.339639127254486,0.0016878780309846182
0,190834,194317,3483,0.01825146462370437,34.169417425990105,4.723505413316217E-4
64,93799,99374,5575,0.0594356016588663,34.169417425990105,7.560592213390155E-4
128,279033,284300,5267,0.018875903566961613,34.169417425990105,7.142894921601066E-4
65,348415,356415,8000,0.022961123947017208,34.169417425990105,0.0010849280306210087
3,88297,84888,3409,0.03860833323895489,34.169417425990105,4.6231495704837736E-4
4,112187,111754,433,0.003859627229536399,34.169417425990105,5.87217296573621E-5
5,163863,165551,1688,0.010301288271299806,34.169417425990105,2.2891981446103283E-4
6,119387,115569,3818,0.03198003132669386,34.169417425990105,5.177819026138765E-4
7,361459,351338,10121,0.028000409451694384,34.169417425990105,0.0013725695747394038
8,106365,110830,4465,0.04197809429793635,34.169417425990105,6.055254570903505E-4
9,480448,488347,7899,0.01644090515518849,34.169417425990105,0.0010712308142344184
270,44134,46718,2584,0.05854896451715231,34.169417425990105,3.504317538905858E-4
207,114984,116385,1401,0.012184303903151743,34.169417425990105,1.8999802136250417E-4
208,102800,103817,1017,0.009892996108949417,34.169417425990105,1.3792147589269574E-4
209,296934,332982,36048,0.12140071531047303,34.169417425990105,0.004888685705978266
18,111558,112981,1423,0.01275569658832177,34.169417425990105,1.9298157344671194E-4
82,114106,116601,2495,0.021865633709007414,34.169417425990105,3.383619295499271E-4
19,102600,111237,8637,0.0841812865497076,34.169417425990105,0.0011713154250592066
83,121361,128884,7523,0.061988612486713196,34.169417425990105,0.0010202391967952312
20,343261,325996,17265,0.05029700432032768,34.169417425990105,0.0023414103060839645
84,330660,346380,15720,0.04754128107421521,34.169417425990105,0.0021318835801702823
151,128208,124562,3646,0.028438162985149132,34.169417425990105,4.944559499555247E-4
152,105434,109001,3567,0.03383159132727583,34.169417425990105,4.8374228565314226E-4
153,277621,294604,16983,0.061173326225321574,34.169417425990105,0.002303166593004574
31,128751,115908,12843,0.09975068154810449,34.169417425990105,0.0017417163371582019
32,125532,131286,5754,0.04583691807666571,34.169417425990105,7.803344860241605E-4
33,274619,295699,21080,0.07676089418430626,34.169417425990105,0.002858785360686358
103,115183,113007,2176,0.018891676723127544,34.169417425990105,2.9510042432891436E-4
104,132213,128319,3894,0.029452474416282817,34.169417425990105,5.28088718904776E-4
105,373310,355524,17786,0.04764404918164528,34.169417425990105,0.0024120662440781575
46,114937,116135,1198,0.01042310135117499,34.169417425990105,1.6246797258549607E-4
238,108277,125131,16854,0.15565632590485515,34.169417425990105,0.00228567212851081
47,125407,127145,1738,0.013858875501367548,34.169417425990105,2.3570061465241415E-4
239,116755,117986,1231,0.010543445676844674,34.169417425990105,1.669433007118077E-4
48,329060,350284,21224,0.0644988755849997,34.169417425990105,0.002878314065237536
240,234584,287524,52940,0.2256760904409508,34.169417425990105,0.007179511242634526
178,111003,116300,5297,0.047719431006369196,34.169417425990105,7.183579722749355E-4
179,110533,109122,1411,0.012765418472311437,34.169417425990105,1.913541814007804E-4
180,285581,292915,7334,0.025680980177252687,34.169417425990105,9.946077720718097E-4
126,109283,120766,11483,0.10507581234043721,34.169417425990105,0.0015572785719526305
63,110891,113133,2242,0.02021805196093461,34.169417425990105,3.040510805815377E-4
127,100604,118378,17774,0.17667289570991213,34.169417425990105,0.002410438852032226
0,208834,210515,1681,0.008049455548426022,36.99596106540412,1.9723808020819704E-4
64,151863,77328,74535,0.49080421169080024,36.99596106540412,0.008745473116191534
128,354374,280819,73555,0.20756319594552647,36.99596106540412,0.00863048601410704
65,361977,385218,23241,0.06420573682858303,36.99596106540412,0.002726954326067048
3,86107,90724,4617,0.05361933408433693,36.99596106540412,5.417300513511278E-4
4,117395,120878,3483,0.02966906597384897,36.99596106540412,4.086735475104999E-4
5,169989,179317,9328,0.05487413891487096,36.99596106540412,0.001094489477800156
6,116697,123959,7262,0.06222953460671654,36.99596106540412,8.520778932016223E-4
7,396806,377650,19156,0.048275479705448,36.99596106540412,0.002247645844418931
8,118421,117350,1071,0.009044004019557341,36.99596106540412,1.2566447584948188E-4
9,446947,586938,139991,0.31321610839763997,36.99596106540412,0.016425672865214583
270,56174,52726,3448,0.06138070993698152,36.99596106540412,4.0456686529319655E-4
207,131038,125919,5119,0.039065004044628274,36.99596106540412,6.006316077250213E-4
208,124103,112476,11627,0.09368830729313554,36.99596106540412,0.0013642398325881661
209,305129,360859,55730,0.18264406201967037,36.99596106540412,0.0065390114277232726
18,127008,122072,4936,0.03886369362559839,36.99596106540412,5.791595264174067E-4
82,129677,125905,3772,0.02908765625361475,36.99596106540412,4.425830092476617E-4
19,157983,119754,38229,0.24198173221169367,36.99596106540412,0.004485552985293971
83,146422,139528,6894,0.047083088606903335,36.99596106540412,8.088990630311187E-4
20,346121,324848,21273,0.06146116531501989,36.99596106540412,0.0024960414516769637
84,399421,356150,43271,0.10833431391939832,36.99596106540412,0.005077149892140925
151,128304,135112,6808,0.05306147898740491,36.99596106540412,7.988083581543162E-4
152,146967,118321,28646,0.19491450461668267,36.99596106540412,0.0033611433941963193
153,370819,301440,69379,0.18709666980386658,36.99596106540412,0.008140500158693935
31,130495,122900,7595,0.058201463657611405,36.99596106540412,8.911500411548226E-4
32,134381,142174,7793,0.05799182920204493,36.99596106540412,9.143821291269956E-4
33,328777,295772,33005,0.1003871925347576,36.99596106540412,0.0038726013309170397
103,128713,119841,8872,0.06892854645606893,36.99596106540412,0.0010409852751975754
104,139356,139361,5,3.587933063520767E-5,36.99596106540412,5.8666888818619E-7
105,403502,384347,19155,0.047471883658569226,36.99596106540412,0.0022475285106412935
46,139925,125942,13983,0.09993210648561729,36.99596106540412,0.0016406782127014988
238,139119,135620,3499,0.025151129608464697,36.99596106540412,4.105508879526957E-4
47,152500,137909,14591,0.09567868852459016,36.99596106540412,0.0017120171495049394
239,149788,126190,23598,0.1575426602932144,36.99596106540412,0.002768842484683542
48,372814,377817,5003,0.013419560424232995,36.99596106540412,5.870208895191017E-4
240,292875,305340,12465,0.042560819462227915,36.99596106540412,0.0014625655382481716
178,132177,126129,6048,0.04575682607412787,36.99596106540412,7.096346871500154E-4
179,143019,117880,25139,0.17577384822995545,36.99596106540412,0.002949653836022526
180,395654,306777,88877,0.22463313905584173,36.99596106540412,0.0104282741550648
126,134215,130576,3639,0.02711321387326305,36.99596106540412,4.26977616821909E-4
63,140811,122099,18712,0.13288734544886407,36.99596106540412,0.0021955496471479973
127,140137,128704,11433,0.08158444950298636,36.99596106540412,0.001341477079726542
0,240780,226701,14079,0.05847246449040618,39.820336513221264,0.0016500170697482924
64,119125,43305,75820,0.6364742917103883,39.820336513221264,0.008885879269004584
128,368827,272757,96070,0.26047442296794976,39.820336513221264,0.011259119247866926
65,371642,413999,42357,0.1139725865214373,39.820336513221264,0.004964114853564062
3,98806,96556,2250,0.02277189644353582,39.820336513221264,2.636933309847047E-4
4,124611,129994,5383,0.043198433525130205,39.820336513221264,6.30871644751407E-4
5,183913,193072,9159,0.04980072099307825,39.820336513221264,0.001073407652661738
6,136339,132343,3996,0.029309295212668424,39.820336513221264,4.683193558288356E-4
7,478189,403942,74247,0.15526705967724058,39.820336513221264,0.008701528331387277
8,118884,123864,4980,0.04188957302917129,39.820336513221264,5.836412392461465E-4
9,507155,722829,215674,0.42526249371493924,39.820336513221264,0.02527635354079787
270,54464,59263,4799,0.0881132491186839,39.820336513221264,5.624285757313769E-4
207,145642,135447,10195,0.07000041196907486,39.820336513221264,0.0011948237819506954
208,111192,121128,9936,0.089358946686812,39.820336513221264,0.001164469749628456
209,304205,388715,84510,0.27780608471261153,39.820336513221264,0.00990432151178551
18,131672,131155,517,0.003926423233489277,39.820336513221264,6.059086760848549E-5
82,125997,135201,9204,0.07304935831805519,39.820336513221264,0.0010786815192814323
19,121371,128264,6893,0.05679280882583154,39.820336513221264,8.078391691011421E-4
83,126982,150165,23183,0.1825691830338158,39.820336513221264,0.0027169788854304044
20,370011,319272,50739,0.13712835564348086,39.820336513221264,0.005946460409259081
84,391407,362698,28709,0.07334820276591886,39.820336513221264,0.0033646097063288393
151,130557,145655,15098,0.11564297586494787,39.820336513221264,0.0017694408494253653
152,129525,127633,1892,0.014607218683651805,39.820336513221264,2.217367920991384E-4
153,345084,305306,39778,0.11527048486745256,39.820336513221264,0.004661863697737593
31,134509,129886,4623,0.03436944739757191,39.820336513221264,5.418018973965734E-4
32,134432,153054,18622,0.13852356581766245,39.820336513221264,0.0021824432042654098
33,384137,291746,92391,0.24051575349419607,39.820336513221264,0.010827951352447936
103,130860,126239,4621,0.035312547760965915,39.820336513221264,5.415675033245869E-4
104,110776,150395,39619,0.35764967140896947,39.820336513221264,0.004643229369014674
105,407426,413148,5722,0.014044268161580262,39.820336513221264,6.706014399531024E-4
46,136354,135742,612,0.004488317174413658,39.820336513221264,7.172458602783969E-5
238,153270,146100,7170,0.04678019181835976,39.820336513221264,8.40302748071259E-4
47,114185,148665,34480,0.301966107632351,39.820336513221264,0.004040953801045608
239,102592,134389,31797,0.3099364472863381,39.820336513221264,0.0037265141534758473
48,392946,405328,12382,0.031510691036427396,39.820336513221264,0.0014511336996678285
240,322283,323142,859,0.00266535932705107,39.820336513221264,1.006722539181606E-4
178,132648,135950,3302,0.024892949761775526,39.820336513221264,3.869846128495533E-4
179,102301,126632,24331,0.2378373622936237,39.820336513221264,0.0028515210827506003
180,350102,318931,31171,0.0890340529331452,39.820336513221264,0.003653148808944103
126,128167,140378,12211,0.09527413452760851,39.820336513221264,0.001431093006512991
63,130110,131059,949,0.007293828299131504,39.820336513221264,1.112199871575488E-4
127,126081,139023,12942,0.10264829752302092,39.820336513221264,0.0015167640398240216
0,255154,242919,12235,0.047951433252075217,42.65019712224603,0.0012106415341376175
64,176049,-4425,180474,1.0251350476287853,42.65019712224603,0.017857729483608694
128,397149,260085,137064,0.3451198416715137,42.65019712224603,0.013562351551699093
65,434503,442835,8332,0.019175932041896143,42.65019712224603,8.244434215312325E-4
3,99752,102399,2647,0.02653580880583848,42.65019712224603,2.6191811531363086E-4
4,144411,139128,5283,0.036583085776014296,42.65019712224603,5.227477911605258E-4
5,205180,206854,1674,0.008158689930792475,42.65019712224603,1.6564069702871856E-4
6,134835,140743,5908,0.04381651648310898,42.65019712224603,5.845909426796113E-4
7,569320,430285,139035,0.24421239373287432,42.65019712224603,0.01375738011432968
8,122979,130391,7412,0.06027045267891266,42.65019712224603,7.334103024951386E-4
9,517113,902940,385827,0.7461173863352885,42.65019712224603,0.03817721219384672
270,61175,66348,5173,0.08456068655496526,42.65019712224603,5.118633964931667E-4
207,146108,144992,1116,0.00763818545185753,42.65019712224603,1.1042713135247906E-4
208,168123,129797,38326,0.22796405012996437,42.65019712224603,0.003792321000192753
209,410774,416625,5851,0.014243842112694572,42.65019712224603,5.789508472610707E-4
18,154506,140256,14250,0.09222942798337928,42.65019712224603,0.0014100238546351492
82,133579,144516,10937,0.08187664228658696,42.65019712224603,0.0010822056770627808
19,194967,136791,58176,0.29838895813137606,42.65019712224603,0.005756459492438908
83,191482,160822,30660,0.16011948903813414,42.65019712224603,0.003033777640920258
20,409087,309244,99843,0.24406299882421098,42.65019712224603,0.009879369243392083
84,457146,366034,91112,0.19930612977035783,42.65019712224603,0.009015445153931068
151,157737,156218,1519,0.009629953657036713,42.65019712224603,1.5030359545198537E-4
152,195975,136963,59012,0.3011200408215334,42.65019712224603,0.005839180891910836
153,406111,306206,99905,0.24600417127337107,42.65019712224603,0.009885504084022778
31,137552,136886,666,0.004841805280911946,42.65019712224603,6.59000622587375E-5
32,194984,163954,31030,0.1591412628728511,42.65019712224603,0.0030703887866195562
33,446759,283602,163157,0.36520137255209184,42.65019712224603,0.01614422891583909
103,137155,132217,4938,0.03600306222886515,42.65019712224603,4.886103715219906E-4
104,164961,161450,3511,0.021283818599547772,42.65019712224603,3.4741008797361465E-4
105,427976,442005,14029,0.03277987550703778,42.65019712224603,0.0013881561162580006
46,139152,145561,6409,0.0460575485799701,42.65019712224603,6.341644129373102E-4
238,147347,156601,9254,0.06280412902875525,42.65019712224603,9.156744386521874E-4
47,194468,159442,35026,0.1801118950161466,42.65019712224603,0.0034657891601719815
239,176738,142603,34135,0.19313899670699,42.65019712224603,0.003377625563366373
48,470425,432894,37531,0.0797810490513897,42.65019712224603,0.003713656511460476
240,375321,340979,34342,0.09150034237359488,42.65019712224603,0.003398108015149494
178,143377,145791,2414,0.016836731135398287,42.65019712224603,2.388629884273158E-4
179,158117,135401,22716,0.1436657664893718,42.65019712224603,0.0022477264478520734
180,415142,329407,85735,0.2065196968748043,42.65019712224603,0.00848339615278207
126,143107,150199,7092,0.04955732423990441,42.65019712224603,7.017466089173669E-4
63,125074,140036,14962,0.11962518189231974,42.65019712224603,0.0014804755728456914
127,182068,149361,32707,0.17964167234220182,42.65019712224603,0.0032363263307755665
0,279002,259154,19848,0.07113927498727608,45.48316090647131,0.0019631595038413063
64,159772,-67505,227277,1.422508324362216,45.48316090647131,0.02247989734756855
128,426671,242792,183879,0.43096202929189,45.48316090647131,0.01818741467184782
65,454420,471704,17284,0.03803529774217684,45.48316090647131,0.0017095550616884894
3,106243,108249,2006,0.018881243940777274,45.48316090647131,1.9841283578726622E-4
4,152339,148272,4067,0.02669703752814447,45.48316090647131,4.022657044600258E-4
5,229206,220651,8555,0.03732450284896556,45.48316090647131,8.461723879162824E-4
6,145017,149152,4135,0.02851389837053587,45.48316090647131,4.089915633002721E-4
7,457581,456657,924,0.0020193146131504587,45.48316090647131,9.139255247628813E-5
8,147106,136925,10181,0.06920859788179952,45.48316090647131,0.0010069995419492311
9,613362,1133825,520463,0.84854131817752,45.48316090647131,0.051478833376045835
270,56320,73977,17657,0.3135120738636364,45.48316090647131,0.0017464483756210168
207,148158,154549,6391,0.04313638143063486,45.48316090647131,6.321318212943262E-4
208,161446,138475,22971,0.14228286857525116,45.48316090647131,0.002272054462048501
209,409981,444566,34585,0.08435756778972685,45.48316090647131,0.0034207915880870403
18,139454,149367,9913,0.07108437190758243,45.48316090647131,9.804917453435545E-4
82,149698,153841,4143,0.02767572045050702,45.48316090647131,4.097828408108893E-4
19,168108,145327,22781,0.13551407428557832,45.48316090647131,0.002253261621171342
83,146290,171491,25201,0.17226741404060428,45.48316090647131,0.002492623068133049
20,437499,294753,142746,0.32627731720529646,45.48316090647131,0.01411896244132059
84,440391,366142,74249,0.16859790504347275,45.48316090647131,0.0073439454857271835
151,136146,166792,30646,0.2250965874869625,45.48316090647131,0.00303118632379689
152,166105,146304,19801,0.11920773005026941,45.48316090647131,0.00195851074846643
153,448077,304126,143951,0.3212639791821495,45.48316090647131,0.014238148616357308
31,148855,143894,4961,0.033327735044170505,45.48316090647131,4.906909662714993E-4
32,168125,174867,6742,0.04010111524163569,45.48316090647131,6.668491220726565E-4
33,449249,271329,177920,0.39603872240116283,45.48316090647131,0.017598011836126824
103,153213,137769,15444,0.10080084588122418,45.48316090647131,0.0015275612342465301
104,165432,172517,7085,0.042827264374486196,45.48316090647131,7.007751453403695E-4
105,451340,470894,19554,0.043324323126689414,45.48316090647131,0.0019340800553261236
46,138859,155391,16532,0.11905602085568814,45.48316090647131,0.0016351749756904712
238,149357,167113,17756,0.11888294489043032,45.48316090647131,0.0017562404348149048
47,160613,170231,9618,0.05988307297665818,45.48316090647131,9.513133871395447E-4
239,163494,150826,12668,0.07748296573574566,45.48316090647131,0.0012529879380623573
48,491219,460489,30730,0.06255865510088168,45.48316090647131,0.0030394947376583704
240,359782,358835,947,0.0026321494682891304,45.48316090647131,9.366747531931262E-5
178,150290,155642,5352,0.035611151773238404,45.48316090647131,5.293646546029157E-4
179,138058,144179,6121,0.04433643830853699,45.48316090647131,6.054262053109953E-4
180,391604,338188,53416,0.1364031010919194,45.48316090647131,0.005283359938391133
126,146994,160032,13038,0.08869749785705539,45.48316090647131,0.0012895845229284034
63,138702,149023,10321,0.0744113278827991,45.48316090647131,0.0010208468983850323
127,199151,159710,39441,0.19804570401353747,45.48316090647131,0.0039010970370316886
0,300346,275341,25005,0.08325398040926132,48.30767201818526,0.0023371061326580883
64,184542,-147248,331790,1.7979105027581797,48.30767201818526,0.03101093556307247
128,412037,220963,191074,0.4637301989869842,48.30767201818526,0.017858836920276407
65,479434,500486,21052,0.043910110672167595,48.30767201818526,0.0019676368048277574
3,118575,114081,4494,0.0379000632511069,48.30767201818526,4.200341915683043E-4
4,168096,157389,10707,0.06369574528840663,48.30767201818526,0.0010007356673613337
5,256031,234406,21625,0.08446242837781362,48.30767201818526,0.0020211925662359993
6,158078,157536,542,0.003428687103834816,48.30767201818526,5.065832929016932E-5
7,581164,482950,98214,0.16899532662036879,48.30767201818526,0.009179625743366586
8,149348,143439,5909,0.03956531054985671,48.30767201818526,5.522879479254807E-4
9,741010,1420878,679868,0.9174882930054925,48.30767201818526,0.06354423804031151
270,50094,82118,32024,0.6392781570647184,48.30767201818526,0.0029931408435210005
207,157581,164076,6495,0.041216897976278866,48.30767201818526,6.070587615122689E-4
208,171491,147128,24363,0.1420657643841368,48.30767201818526,0.0022771012481483306
209,384431,472423,87992,0.2288889293527317,48.30767201818526,0.008224220868820256
18,147059,158450,11391,0.07745870704955155,48.30767201818526,0.0010646661050633186
82,158140,163138,4998,0.03160490704439105,48.30767201818526,4.6714082987503E-4
19,175538,153837,21701,0.12362565370461097,48.30767201818526,0.0020282959482028863
83,199658,182128,17530,0.08780013823638422,48.30767201818526,0.0016384511299938527
20,489844,275871,213973,0.43681866063481434,48.30767201818526,0.019999104600009962
84,499021,363030,135991,0.27251558551644117,48.30767201818526,0.01271047390867051
151,167745,177335,9590,0.05717010939223226,48.30767201818526,8.963346455585309E-4
152,156489,155616,873,0.005578666871153883,48.30767201818526,8.159542706700704E-5
153,396344,299084,97260,0.24539289102395898,48.30767201818526,0.009090459606571713
31,158433,150881,7552,0.04766683708570815,48.30767201818526,7.058518501833187E-4
32,187210,185747,1463,0.007814753485390737,48.30767201818526,1.367401028625788E-4
33,455250,254987,200263,0.4398967600219659,48.30767201818526,0.018717691879404388
103,164599,142872,21727,0.13199958687476837,48.30767201818526,0.0020307260525599794
104,182852,183551,699,0.003822763765230897,48.30767201818526,6.533242098492317E-5
105,428907,499697,70790,0.16504743452543325,48.30767201818526,0.006616426439946654
46,154966,165191,10225,0.06598221545371243,48.30767201818526,9.556852712029175E-4
238,161022,177593,16571,0.10291140341071406,48.30767201818526,0.0015488176654379997
47,178704,180988,2284,0.012780911451338526,48.30767201818526,2.1347532121539987E-4
239,169213,159025,10188,0.060208140036522015,48.30767201818526,9.522270457716698E-4
48,452708,488002,35294,0.07796195340042589,48.30767201818526,0.0032987731992015425
240,376889,376638,251,6.659785772468817E-4,48.30767201818526,2.3459853601166974E-5
178,165550,165464,86,5.194805194805195E-4,48.30767201818526,8.038037488846054E-6
179,144254,152931,8677,0.060150845037226,48.30767201818526,8.110005964036886E-4
180,361714,345244,16470,0.04553321132165191,48.30767201818526,0.0015393776446662154
126,164206,169834,5628,0.03427402165572513,48.30767201818526,5.260241277584371E-4
63,177928,157984,19944,0.11209028371026483,48.30767201818526,0.0018640769729947177
127,171536,170029,1507,0.008785327861206976,48.30767201818526,1.408525871591977E-4
